No pains, No gains - 
http://club.cyworld.com/bbohahal7942 by. YJM
VOCA-MAKE & TAKE
make a regular habit : A하는 습 을 들이다
make a commitment to N : -에 헌신하다, 전념하다.
make a point of -ing : 정해놓고 반드시 -하다.
make quick money : 쉽게 을 벌다.
make clear : 히 하다.
make a call : 전 를 걸다.
make a correction : 정정하다, 수정하다.
make a final change : 최종 수정을 하다.
make an impression : 인상을 주다, 감동시키다.
make a note of N : -을 적어 다.
make a copy : 복사하다.
make a selection : 정하다.
make an outside call :  전 를 걸다. 
make a business contact : 사업상 연락을 취하다. 
make it : (행사에)참여하다, (일을)이뤄내다.
make room for N : -을 위해 공간을 마 하다. 
make an error : 실수를 범하다.
make a presentation : 발표하다.
make a revision : 수정하다.
make out : ( 류를)작 하다, 입하다.
make up the time : 보충근무를 하다. 
make an assesment : 평가를 내리다.
make up one's mind : 결정을 내리다. 
make a purchase : 매하다.
make no difference : 상 없다, 하  않다.
make payment : 하다. 
make an arrangement : 비하다.
make an exception : 를 다.
make public : 발표하다.
make a complaint : 평하다.
make a request : 청하다.
make a response : 응답하다.
make a deposit : 계약 을 르다, 보 을 르다.
make a mistake : 실수하다.
make a contract with N : -  계약을 맺다. 
make a move : 행동을 취하다. 
make a recording : 녹음하다, 녹 하다.
make a delivery : 배달하다.
make money : 을 벌다.
make a profit : 수익을 얻다.
make forecast : 하다.
make the first move : 개시하다, 발달은 만들다. 
make a stop : 정 하다.
make a transfer : 차를 갈아타다 ; 바꾸다.
make a speech : 발표하다.
make adjustments : 조정하다.
make an announcement : 발표하다.
make an appointment : 약 을 잡다.
make an offer : 제안하다.
make a conclusion : 결 을 내리다.
make a decision : 결정을 내리다.
make a proposal  : 제안하다.
make repairs : 수리하다.
make the bed : 잠자리를 비하다.
make progress : 보하다, 발전하다.
take an examination : 시험을 르다.
take one's advice : -의 충고를 르다. 
take a message : 를 남겨주다.
take A out of B : B 터 A를 내다, 리고 나 다.
tkae the place of N : -을 신하다. 
take turns :  하다. 
take charge of N : -을 담당하다. 
take off one's glass : 안경을 벗다.
take on responsibility : 책임을 다. 
take on the coordination of  N : -을 조정하다.
take another look : 다시 한번 보다.
take out : -을 내다.
take care of : -을 돌보다, 책임 다.
take a break : 잠  휴식을 취하다. 
take A for a walk : A를 산책에 가다.
take a photograph : 사 을 찍다.
take a walk : 산책하다.
take great pleasure : 큰 거 을 찾다.
take one's time : 천천히 하다, 여유를 갖다. 
take a tour : 여행하다, 러보다 cf) tour of N <-> trip to N 
take a long time : 래 걸리다.
take a stand against : -에 반 하다, 맞 다.
take action : 조 를 취하다.
take ten percent off : 10퍼 를 할인하다. 
take an alternate seat : 다른자리를 차 하다. 
take the order : 주문을 받다. 
take apart :(물건을) 해하다. 
take the edge off : -을 가라 앉히다. cf) on the edge of N : -을 막 
할 는 찰나에
take off : 이륙하다 cf) touch down : 착륙하다.
take one's bag off : 가방을 내  놓다. 
take A seriously : A를 하게 받아들이다. 
take an action against N : -을 고 하다.
take a turn for the better : 전 다. 
take out a loan : 융자를 받다.
take out insurance on N : -에 보험을 들다. 
take precautions : 조심하다.
take steps : 조 를 취하다. 
take a look : 보다.
take a seat : 자리에 앉다.
take down : -을 적다.
take notes : 하다.
take part in N : -에 참가하다.
take a vacation : 휴가를 얻다.
take place : 일어나다, 발생하다.
take some time off : 휴식을 취하다, 일을 쉬다. 
take early retirement : 조  퇴  하다.
take one's place : -의 자리를 차 하다.
take over : 인수하다.
take effect : 과가 나타나다.
take medication : 약을 복 하다.
take some medicine : 약을 다. 
